################################
#..............................#
#..........................#####
#..............................#
#..............................#
#..............................#
#..............................#
#......................####....#
#..............................#
#.......@.......#####..........#
#......#####...................#
#......................P.......#
################################