################################
#..............................#
#..........................#####
#..............................#
#..............................#
#..............................#
#............B.................#
#......................####....#
#..............................#
#.......@.......#####..........#
#......#####...................#
#..............................#
################################