#################
#...............#
#..........#..###
#...............#
#......#........#
#...............#
#..#............#
#....#..........#
#........##.....#
#.@.............#
#......##.......#
#...##..........#
#################