#############################################################
#...........................................................#
#....@......................................................#
#...........................................................#
#...........................................................#
#...........................................................#
#...........................................................#
#............................................................
#.........................................###................
########....................................................#
#......................####.................................#
#...........................................................#
/////////////////////////////////////////////////////////////