################################
#..............................#
#..............................#
#..............................#
#..............................#
#..............................#
#..............................#
#............#.................#
#.........#.####...............#
#.........###.##...............#
#..@......##...................#
#.........#....................#
################################