###################
###################
#......############
#.....#############
#....##########..##
#.....#####.......#
#...............###
#.................#
#........##...#####
#.@.......#########
#.........#########
#...##.############
###################