#############################################
#...........................................#
#...........................................#
#...........................................#
#...........................................#
#...........................................#
#...........................................#
#...........................................#
#...........................................#
#...........................................#
#...........................................#
#...........................................#
#...........................................#
#...........................................#
#...........................................#
#...........................................#
#...........................................#
#...........................................#
#.....................@.....................#
#############################################