######################################
#....................................#
#....................................#
#....................................#
#.....................................
#.....................................
#....................................#
#.........................######.....#
#....................................#
#..@.................................#
#................####................#
#.......#####........................#
######################################