###########################################################################################################
#.........................................................................................................#
#.........................................................................................................#
#..@......................................................................................................#
#.........................................................................................................#
#.........................................................................................................#
#........................................#../////.#....//...//............................................#
#......................###......................................................................#.........#
#......................#####...........#.............................................................///..#
#......................##.................................#.......#............................//.........#
#..#.../////.#./////..............#.......................///././//......#..//////##../////.#..//..#.......
#.....................#......#...............................///.............................////////......
//////////////////////////////////////////////////////////////////////////////////////////////////////////#
///////////////////////////////////////////////////////////////////////////////////////////////////////////